##############^#########
#||||||-||----@--------#
#||--|--------@|@---|--#
#----|------|-@@@-|----#
#---------|---@--------#
#---|-|-------@@-------#
#---%%%%%------@---%%%%%
#--%%%%%%%%%%%%@%%%%%%%%
#-%%-----%%%%%%@%%%----#
%%%-------%%%%%@%%---@@=
#--------------@---@@@-#
#--@@@@@@@-----@@@@@---#
=@@@-----@@@@@@@-@|@---#
#-------|--------@@@---#
#----|-----|------@----#
#----------------------#
########################